111111111111111111111111111111
10000000000010110000000000E101
100001000000101100000000000101
1111000000101011000C0000000101
100000000010101100000000000101
100000001111101100000000000101
10000C000000001100000000000101
1P0000000000001100000000000101
111111000111101100000000000101
100000000000001100000000000101
11000C000000000000000000000001
110000000000C00000000000000001
111111111111111111111111111111