111111111111111111111111111111
10000000000010110000000000E101
100001000000101100000000000101
1111000000101000000C0000000101
100000000010100000000000000101
100000000000000000000000000101
1P000C000000001100000000000101
111111111111111111111111111111